33 33 33 33 33 33 33 33 33 33 33 33 33 33 33 33 33 33 33 33 33 33 33 33 33 33 33 33 33 33 33 33 33 33 33 33 33 33 33 33 33 33 33 33 33 33 33 33 33 33 
33 33 33 33 33 33 33 33 33 33 33 33 33 33 33 33 33 33 33 33 33 33 33 33 33 33 33 33 33 33 33 33 33 33 33 33 33 33 33 33 33 33 33 33 33 33 33 33 33 33 
33 33 33 33 33 33 33 33 33 33 33 33 33 33 33 33 33 33 33 33 33 33 33 33 33 33 33 33 33 33 33 33 33 33 33 33 33 33 33 33 33 33 33 33 33 33 33 33 33 33 
33 33 33 33 33 33 33 33 33 33 33 33 33 33 33 33 33 33 33 33 33 33 33 33 33 33 33 33 33 33 33 33 33 33 33 33 33 33 33 33 33 33 33 33 33 33 33 33 33 33 
33 33 33 33 33 33 33 33 33 33 33 33 33 33 33 33 33 33 33 33 33 33 33 33 33 33 33 33 33 33 33 33 33 33 33 33 33 33 33 33 33 33 33 33 33 33 33 33 33 33 
33 33 33 33 33 33 33 33 33 33 33 33 33 33 33 33 33 33 33 33 33 33 33 33 33 33 33 33 33 33 33 33 33 33 33 33 33 33 33 33 33 33 33 33 33 33 33 33 33 33 
33 33 33 33 33 33 33 33 33 33 33 33 33 33 33 33 33 33 33 33 33 33 33 33 33 33 33 33 33 33 33 33 33 33 33 33 33 33 33 33 33 33 33 33 33 33 33 33 33 33 
33 33 33 33 33 33 33 33 37 29 33 33 33 33 33 33 33 33 33 33 33 33 33 33 33 33 33 33 33 33 33 33 33 33 33 33 33 33 33 33 33 33 33 33 33 33 33 33 33 33
33 33 33 33 33 33 33 33 29 29 33 33 33 33 33 29 29 29 29 29 29 33 33 33 33 33 33 33 33 33 33 29 29 29 29 29 29 33 33 33 33 33 33 33 33 33 33 33 33 33 
33 33 33 33 33 33 33 33 33 29 33 33 33 33 29 29 29 29 29 29 29 29 33 33 33 33 33 33 33 33 29 29 29 29 33 33 29 33 33 33 33 33 33 33 33 33 33 33 33 33 
33 33 33 33 33 33 33 33 33 29 29 29 29 29 29 29 29 29 29 29 29 29 33 33 33 33 29 29 29 29 29 29 29 33 33 33 29 29 33 33 33 33 33 33 33 33 33 33 33 33 
33 33 33 33 33 33 33 33 33 33 33 33 33 33 29 29 29 29 29 29 29 29 33 33 33 29 29 29 29 29 29 29 33 33 33 33 33 29 33 33 33 33 33 33 33 33 33 33 33 33 
33 33 33 33 33 33 33 33 33 33 33 33 33 33 33 29 29 29 29 29 29 33 33 33 29 29 29 29 29 29 33 33 33 33 33 33 33 29 29 33 33 33 33 33 33 33 33 33 33 33 
33 33 33 33 33 33 33 33 33 33 33 33 33 33 33 33 33 33 29 33 33 33 33 29 29 29 29 33 33 33 33 33 33 33 33 33 29 29 29 29 33 33 33 33 33 33 33 33 33 33 
33 33 33 33 33 33 33 33 33 33 33 33 33 33 33 33 33 33 29 33 33 33 29 29 29 33 33 33 33 33 33 33 33 33 33 29 29 29 29 29 33 33 33 33 33 33 33 33 33 33 
33 33 33 33 33 33 33 33 33 33 33 33 33 33 33 29 29 29 29 29 33 33 29 29 29 33 33 29 33 33 33 33 33 33 33 29 29 29 29 29 29 33 33 33 33 33 33 33 33 33 
33 33 33 33 33 33 33 33 33 33 33 33 33 29 29 29 33 29 29 29 33 33 29 33 33 33 33 29 33 33 33 33 33 33 29 29 29 29 29 29 29 33 33 33 33 33 33 33 33 33 
33 33 33 33 33 33 33 33 29 29 33 33 33 33 33 33 33 33 29 33 33 33 29 33 33 29 29 29 29 29 33 33 29 29 29 33 33 29 29 29 33 33 33 33 33 33 33 33 33 33 
33 33 33 33 33 33 33 33 29 29 29 29 29 33 33 33 33 33 29 33 33 33 29 33 33 29 29 29 29 29 33 29 29 33 33 33 33 33 29 33 33 33 33 33 33 33 33 33 33 33 
33 33 33 33 33 33 33 33 29 29 29 29 29 33 33 33 33 33 29 33 33 33 29 33 33 29 29 29 29 29 29 29 33 33 33 33 33 33 29 33 33 33 33 33 33 33 33 33 33 33 
33 33 33 33 33 33 33 33 29 29 29 29 29 33 33 33 33 33 29 33 33 33 29 33 33 33 29 29 29 29 33 33 33 33 33 33 33 33 29 33 33 33 33 33 33 33 33 33 33 33 
33 33 33 33 33 33 33 33 29 29 29 29 29 33 33 33 33 33 29 33 33 33 29 29 33 33 33 33 33 33 33 33 33 33 33 33 33 33 29 33 33 33 33 33 33 33 33 33 33 33 
33 33 33 33 33 33 33 33 33 33 29 33 33 33 33 33 33 33 29 33 29 29 29 29 33 33 33 33 33 33 33 33 33 33 33 33 33 33 29 33 33 33 33 33 33 33 33 33 33 33 
33 33 33 33 33 33 33 33 33 33 29 33 33 33 33 33 33 33 29 33 33 33 33 33 33 33 33 33 33 33 33 33 33 33 33 33 33 29 29 29 29 33 33 33 33 33 33 33 33 33 
33 33 33 33 33 33 33 33 33 33 29 33 33 33 29 29 29 29 29 29 29 29 33 33 33 33 33 33 33 33 33 33 33 33 29 29 29 29 29 29 29 33 33 33 33 33 33 33 33 33 
33 33 33 33 33 33 33 33 33 33 29 33 33 29 29 29 29 29 29 29 29 29 29 33 33 33 33 33 33 33 33 33 29 29 29 29 29 29 29 29 29 33 33 33 33 33 33 33 33 33 
33 33 33 33 33 33 33 33 33 33 29 29 29 29 29 29 29 29 29 29 29 29 29 33 33 33 33 33 33 33 33 33 29 29 29 29 29 29 29 29 29 33 33 33 33 33 33 33 33 33 
33 33 33 33 33 33 33 33 33 33 29 29 29 29 29 29 29 29 29 29 29 29 29 33 33 33 33 33 33 33 33 33 29 29 29 29 29 29 29 29 29 33 33 33 33 33 33 33 33 33 
33 33 33 33 33 33 33 33 33 33 33 33 33 33 29 29 29 29 29 29 29 29 29 29 29 29 29 29 29 29 29 29 29 29 29 29 29 33 33 29 29 33 33 33 33 33 33 33 33 33 
33 33 33 33 33 33 33 33 33 33 33 33 33 33 33 33 33 29 29 33 33 33 33 33 33 33 29 33 33 33 33 33 29 29 29 33 33 33 33 29 29 33 33 33 33 33 33 33 33 33 
33 33 33 33 33 33 33 33 33 33 33 33 33 33 33 33 33 29 29 33 33 33 33 33 33 33 29 33 33 33 33 33 33 33 33 33 33 33 29 29 29 29 33 33 33 33 33 33 33 33
33 33 33 33 33 33 33 33 33 33 33 33 33 33 33 33 33 29 29 33 33 33 33 33 33 33 29 33 33 33 33 33 33 33 33 33 33 33 33 29 29 29 33 33 33 33 33 33 33 33
33 33 33 33 33 33 33 33 33 33 33 33 33 33 33 33 33 29 29 33 33 33 33 33 33 33 29 33 33 33 33 33 33 33 33 33 33 33 33 33 33 33 33 33 33 33 33 33 33 33 
33 33 33 33 33 33 33 33 33 33 33 33 33 33 33 33 33 29 29 33 33 33 33 33 33 29 29 29 33 33 33 33 33 33 33 33 33 33 33 33 33 33 33 33 33 33 33 33 33 33 
33 33 33 33 33 33 33 33 33 33 33 33 33 33 33 33 33 29 29 33 33 33 33 33 33 29 29 29 33 33 33 33 33 33 33 33 33 33 33 33 33 33 33 33 33 33 33 33 33 33 
33 33 33 33 33 33 33 33 33 33 33 33 33 33 33 29 29 29 29 29 29 33 33 33 33 33 33 33 33 33 33 33 33 33 33 33 33 33 33 33 33 33 33 33 33 33 33 33 33 33 
33 33 33 33 33 33 33 33 33 33 33 33 33 33 33 29 29 29 29 29 29 33 33 33 33 33 33 33 33 33 33 33 33 33 33 33 33 33 33 33 33 33 33 33 33 33 33 33 33 33 
33 33 33 33 33 33 33 33 33 29 29 29 29 29 29 29 29 29 29 29 29 33 33 33 33 33 33 33 33 33 33 33 33 33 33 33 29 29 29 29 29 33 33 33 33 33 33 33 33 33 
33 33 33 33 33 33 33 33 33 29 33 33 33 33 33 29 29 29 29 29 29 33 33 33 33 33 33 33 33 33 33 33 29 29 29 29 29 29 33 33 29 33 33 33 33 33 33 33 33 33 
33 33 33 33 33 33 33 33 33 29 33 33 33 33 33 29 29 29 29 29 29 33 33 33 33 33 33 33 33 33 33 29 29 29 29 29 29 33 33 33 29 33 33 33 33 33 33 33 33 33 
33 33 33 33 33 33 29 38 29 29 29 33 33 33 33 29 29 29 29 29 29 29 29 29 29 29 29 29 29 29 29 29 29 29 29 29 29 33 33 33 29 33 33 33 33 33 33 33 33 33
33 33 33 33 33 33 29 29 29 29 29 33 33 33 33 33 33 33 33 33 33 33 33 33 33 33 33 33 33 33 33 33 29 29 29 29 29 33 33 33 29 33 33 33 33 33 33 33 33 33
33 33 33 33 33 33 29 29 29 29 29 33 33 33 33 33 33 33 33 33 33 33 33 33 33 33 33 33 33 33 33 33 33 33 33 33 33 33 33 33 33 33 33 33 33 33 33 33 33 33
33 33 33 33 33 33 33 33 33 33 33 33 33 33 33 33 33 33 33 33 33 33 33 33 33 33 33 33 33 33 33 33 33 33 33 33 33 33 33 33 33 33 33 33 33 33 33 33 33 33 
33 33 33 33 33 33 33 33 33 33 33 33 33 33 33 33 33 33 33 33 33 33 33 33 33 33 33 33 33 33 33 33 33 33 33 33 33 33 33 33 33 33 33 33 33 33 33 33 33 33 
33 33 33 33 33 33 33 33 33 33 33 33 33 33 33 33 33 33 33 33 33 33 33 33 33 33 33 33 33 33 33 33 33 33 33 33 33 33 33 33 33 33 33 33 33 33 33 33 33 33 
33 33 33 33 33 33 33 33 33 33 33 33 33 33 33 33 33 33 33 33 33 33 33 33 33 33 33 33 33 33 33 33 33 33 33 33 33 33 33 33 33 33 33 33 33 33 33 33 33 33 
33 33 33 33 33 33 33 33 33 33 33 33 33 33 33 33 33 33 33 33 33 33 33 33 33 33 33 33 33 33 33 33 33 33 33 33 33 33 33 33 33 33 33 33 33 33 33 33 33 33 
33 33 33 33 33 33 33 33 33 33 33 33 33 33 33 33 33 33 33 33 33 33 33 33 33 33 33 33 33 33 33 33 33 33 33 33 33 33 33 33 33 33 33 33 33 33 33 33 33 33 
33 33 33 33 33 33 33 33 33 33 33 33 33 33 33 33 33 33 33 33 33 33 33 33 33 33 33 33 33 33 33 33 33 33 33 33 33 33 33 33 33 33 33 33 33 33 33 33 33 33 
