15 15 15 15 15 15 15 15 15 15 15 15 15 15 15 15 15 15 15 15 15 15 15 15 15 15 15 15 15 15 15 15 15 15 15 15 15 15 15 15 15 15 15 15 15 15 15 15 15 15 
15 15 15 15 15 15 15 15 15 15 15 15 15 15 15 15 15 15 15 15 15 15 15 15 15 15 15 15 15 15 15 15 15 15 15 15 15 15 15 15 15 15 15 15 15 15 15 15 15 15 
15 15 15 15 15 15 15 15 15 15 15 15 15 15 15 15 15 15 15 15 15 15 15 15 15 15 15 15 15 15 15 15 15 15 15 15 15 15 15 15 15 15 15 15 15 15 15 15 15 15 
15 15 15 15 15 15 15 15 15 15 15 15 15 15 15 15 15 15 15 15 15 15 15 15 15 15 15 15 15 15 15 15 15 15 15 15 15 15 15 15 15 15 15 15 15 15 15 15 15 15 
15 15 15 15 15 15 15 15 15 15 15 15 15 15 15 15 15 15 15 15 15 15 15 15 15 15 15 15 15 15 15 15 15 15 15 15 15 15 15 15 15 15 15 15 15 15 15 15 15 15 
15 15 15 15 15 15 15 15 15 15 15 15 15 15 15 15 15 15 15 15 15 15 15 15 15 15 15 15 15 15 15 15 15 15 15 15 15 15 15 15 15 15 15 15 15 15 15 15 15 15 
15 15 15 15 15 15 15 15 15 15 15 15 15 15 15 15 15 15 15 15 15 15 15 15 15 15 15 15 15 15 15 15 15 15 15 15 15 15 15 15 15 15 15 15 15 15 15 15 15 15 
15 15 15 15 15 15 15 15 51 48 15 15 15 15 15 15 15 15 15 15 15 15 15 15 15 15 15 15 15 15 15 15 15 15 15 15 15 15 15 15 15 15 15 15 15 15 15 15 15 15
15 15 15 15 15 15 15 15 48 48 15 15 15 15 15 48 48 48 48 48 48 15 15 15 15 15 15 15 15 15 15 48 48 48 48 48 48 15 15 15 15 15 15 15 15 15 15 15 15 15 
15 15 15 15 15 15 15 15 15 48 15 15 15 15 48 48 48 48 48 48 48 48 15 15 15 15 15 15 15 15 48 48 48 48 15 15 48 15 15 15 15 15 15 15 15 15 15 15 15 15 
15 15 15 15 15 15 15 15 15 48 48 48 48 48 48 48 48 48 48 48 48 48 15 15 15 15 48 48 48 48 48 48 48 15 15 15 48 48 15 15 15 15 15 15 15 15 15 15 15 15 
15 15 15 15 15 15 15 15 15 15 15 15 15 15 48 48 48 48 48 48 48 48 15 15 15 48 48 48 48 48 48 48 15 15 15 15 15 48 15 15 15 15 15 15 15 15 15 15 15 15 
15 15 15 15 15 15 15 15 15 15 15 15 15 15 15 48 48 48 48 48 48 15 15 15 48 48 48 48 48 48 15 15 15 15 15 15 15 48 48 15 15 15 15 15 15 15 15 15 15 15 
15 15 15 15 15 15 15 15 15 15 15 15 15 15 15 15 15 15 48 15 15 15 15 48 48 48 48 15 15 15 15 15 15 15 15 15 48 48 48 48 15 15 15 15 15 15 15 15 15 15 
15 15 15 15 15 15 15 15 15 15 15 15 15 15 15 15 15 15 48 15 15 15 48 48 48 15 15 15 15 15 15 15 15 15 15 48 48 48 48 48 15 15 15 15 15 15 15 15 15 15 
15 15 15 15 15 15 15 15 15 15 15 15 15 15 15 48 48 48 48 48 15 15 48 48 48 15 15 48 15 15 15 15 15 15 15 48 48 48 48 48 48 15 15 15 15 15 15 15 15 15 
15 15 15 15 15 15 15 15 15 15 15 15 15 48 48 48 15 48 48 48 15 15 48 15 15 15 15 48 15 15 15 15 15 15 48 48 48 48 48 48 48 15 15 15 15 15 15 15 15 15 
15 15 15 15 15 15 15 15 48 48 15 15 15 15 15 15 15 15 48 15 15 15 48 15 15 48 48 48 48 48 15 15 48 48 48 15 15 48 48 48 15 15 15 15 15 15 15 15 15 15 
15 15 15 15 15 15 15 15 48 48 48 48 48 15 15 15 15 15 48 15 15 15 48 15 15 48 48 48 48 48 15 48 48 15 15 15 15 15 48 15 15 15 15 15 15 15 15 15 15 15 
15 15 15 15 15 15 15 15 48 48 48 48 48 15 15 15 15 15 48 15 15 15 48 15 15 48 48 48 48 48 48 48 15 15 15 15 15 15 48 15 15 15 15 15 15 15 15 15 15 15 
15 15 15 15 15 15 15 15 48 48 48 48 48 15 15 15 15 15 48 15 15 15 48 15 15 15 48 48 48 48 15 15 15 15 15 15 15 15 48 15 15 15 15 15 15 15 15 15 15 15 
15 15 15 15 15 15 15 15 48 48 48 48 48 15 15 15 15 15 48 15 15 15 48 48 15 15 15 15 15 15 15 15 15 15 15 15 15 15 48 15 15 15 15 15 15 15 15 15 15 15 
15 15 15 15 15 15 15 15 15 15 48 15 15 15 15 15 15 15 48 15 48 48 48 48 15 15 15 15 15 15 15 15 15 15 15 15 15 15 48 15 15 15 15 15 15 15 15 15 15 15 
15 15 15 15 15 15 15 15 15 15 48 15 15 15 15 15 15 15 48 15 15 15 15 15 15 15 15 15 15 15 15 15 15 15 15 15 15 48 48 48 48 15 15 15 15 15 15 15 15 15 
15 15 15 15 15 15 15 15 15 15 48 15 15 15 48 48 48 48 48 48 48 48 15 15 15 15 15 15 15 15 15 15 15 15 48 48 48 48 48 48 48 15 15 15 15 15 15 15 15 15 
15 15 15 15 15 15 15 15 15 15 48 15 15 48 48 48 48 48 48 48 48 48 48 15 15 15 15 15 15 15 15 15 48 48 48 48 48 48 48 48 48 15 15 15 15 15 15 15 15 15 
15 15 15 15 15 15 15 15 15 15 48 48 48 48 48 48 48 48 48 48 48 48 48 15 15 15 15 15 15 15 15 15 48 48 48 48 48 48 48 48 48 15 15 15 15 15 15 15 15 15 
15 15 15 15 15 15 15 15 15 15 48 48 48 48 48 48 48 48 48 48 48 48 48 15 15 15 15 15 15 15 15 15 48 48 48 48 48 48 48 48 48 15 15 15 15 15 15 15 15 15 
15 15 15 15 15 15 15 15 15 15 15 15 15 15 48 48 48 48 48 48 48 48 48 48 48 48 48 48 48 48 48 48 48 48 48 48 48 15 15 48 48 15 15 15 15 15 15 15 15 15 
15 15 15 15 15 15 15 15 15 15 15 15 15 15 15 15 15 48 48 15 15 15 15 15 15 15 48 15 15 15 15 15 48 48 48 15 15 15 15 48 48 15 15 15 15 15 15 15 15 15 
15 15 15 15 15 15 15 15 15 15 15 15 15 15 15 15 15 48 48 15 15 15 15 15 15 15 48 15 15 15 15 15 15 15 15 15 15 15 48 48 48 48 15 15 15 15 15 15 15 15
15 15 15 15 15 15 15 15 15 15 15 15 15 15 15 15 15 48 48 15 15 15 15 15 15 15 48 15 15 15 15 15 15 15 15 15 15 15 15 48 48 48 15 15 15 15 15 15 15 15
15 15 15 15 15 15 15 15 15 15 15 15 15 15 15 15 15 48 48 15 15 15 15 15 15 15 48 15 15 15 15 15 15 15 15 15 15 15 15 15 15 15 15 15 15 15 15 15 15 15 
15 15 15 15 15 15 15 15 15 15 15 15 15 15 15 15 15 48 48 15 15 15 15 15 15 48 48 48 15 15 15 15 15 15 15 15 15 15 15 15 15 15 15 15 15 15 15 15 15 15 
15 15 15 15 15 15 15 15 15 15 15 15 15 15 15 15 15 48 48 15 15 15 15 15 15 48 48 48 15 15 15 15 15 15 15 15 15 15 15 15 15 15 15 15 15 15 15 15 15 15 
15 15 15 15 15 15 15 15 15 15 15 15 15 15 15 48 48 48 48 48 48 15 15 15 15 15 15 15 15 15 15 15 15 15 15 15 15 15 15 15 15 15 15 15 15 15 15 15 15 15 
15 15 15 15 15 15 15 15 15 15 15 15 15 15 15 48 48 48 48 48 48 15 15 15 15 15 15 15 15 15 15 15 15 15 15 15 15 15 15 15 15 15 15 15 15 15 15 15 15 15 
15 15 15 15 15 15 15 15 15 48 48 48 48 48 48 48 48 48 48 48 48 15 15 15 15 15 15 15 15 15 15 15 15 15 15 15 48 48 48 48 48 15 15 15 15 15 15 15 15 15 
15 15 15 15 15 15 15 15 15 48 15 15 15 15 15 48 48 48 48 48 48 15 15 15 15 15 15 15 15 15 15 15 48 48 48 48 48 48 15 15 48 15 15 15 15 15 15 15 15 15 
15 15 15 15 15 15 15 15 15 48 15 15 15 15 15 48 48 48 48 48 48 15 15 15 15 15 15 15 15 15 15 48 48 48 48 48 48 15 15 15 48 15 15 15 15 15 15 15 15 15 
15 15 15 15 15 15 48 50 48 48 48 15 15 15 15 48 48 48 48 48 48 48 48 48 48 48 48 48 48 48 48 48 48 48 48 48 48 15 15 15 48 15 15 15 15 15 15 15 15 15
15 15 15 15 15 15 48 48 48 48 48 15 15 15 15 15 15 15 15 15 15 15 15 15 15 15 15 15 15 15 15 15 48 48 48 48 48 15 15 15 48 15 15 15 15 15 15 15 15 15
15 15 15 15 15 15 48 48 48 48 48 15 15 15 15 15 15 15 15 15 15 15 15 15 15 15 15 15 15 15 15 15 15 15 15 15 15 15 15 15 15 15 15 15 15 15 15 15 15 15
15 15 15 15 15 15 15 15 15 15 15 15 15 15 15 15 15 15 15 15 15 15 15 15 15 15 15 15 15 15 15 15 15 15 15 15 15 15 15 15 15 15 15 15 15 15 15 15 15 15 
15 15 15 15 15 15 15 15 15 15 15 15 15 15 15 15 15 15 15 15 15 15 15 15 15 15 15 15 15 15 15 15 15 15 15 15 15 15 15 15 15 15 15 15 15 15 15 15 15 15 
15 15 15 15 15 15 15 15 15 15 15 15 15 15 15 15 15 15 15 15 15 15 15 15 15 15 15 15 15 15 15 15 15 15 15 15 15 15 15 15 15 15 15 15 15 15 15 15 15 15 
15 15 15 15 15 15 15 15 15 15 15 15 15 15 15 15 15 15 15 15 15 15 15 15 15 15 15 15 15 15 15 15 15 15 15 15 15 15 15 15 15 15 15 15 15 15 15 15 15 15 
15 15 15 15 15 15 15 15 15 15 15 15 15 15 15 15 15 15 15 15 15 15 15 15 15 15 15 15 15 15 15 15 15 15 15 15 15 15 15 15 15 15 15 15 15 15 15 15 15 15 
15 15 15 15 15 15 15 15 15 15 15 15 15 15 15 15 15 15 15 15 15 15 15 15 15 15 15 15 15 15 15 15 15 15 15 15 15 15 15 15 15 15 15 15 15 15 15 15 15 15 
15 15 15 15 15 15 15 15 15 15 15 15 15 15 15 15 15 15 15 15 15 15 15 15 15 15 15 15 15 15 15 15 15 15 15 15 15 15 15 15 15 15 15 15 15 15 15 15 15 15 
