20 20 20 20 20 20 20 20 20 20 20 20 20 20 20 20 20 20 20 25 23 23 23 23 23 23 23 26 20 20 20 20 20 20 20 20 20 20 20 20 20 20 20 20 20 20 20 20 20 20 
20 20 20 20 20 20 20 20 20 20 20 20 20 20 20 20 20 20 25 24 1 1 1 1 1 1 1 22 26 20 20 20 20 20 20 20 20 20 20 20 20 20 20 20 20 20 20 20 20 20 
20 20 20 20 20 20 20 20 20 20 20 20 20 20 20 20 20 20 21 1 1 16 17 17 17 18 1 1 19 20 20 20 20 20 20 20 20 20 20 20 20 20 20 20 20 20 20 20 20 20 
20 20 20 20 20 20 20 20 20 20 20 20 20 20 20 20 20 20 21 1 16 28 20 20 20 27 18 1 19 20 20 20 20 20 20 20 20 20 20 20 20 20 20 20 20 20 20 20 20 20 
20 20 20 20 20 20 20 20 20 20 20 20 20 20 20 25 23 23 24 1 19 20 20 20 20 20 21 1 22 26 20 20 20 20 20 20 20 20 20 20 20 20 20 20 20 20 20 20 20 20 
20 20 20 20 20 20 20 25 23 23 23 23 23 23 23 24 30 30 30 1 22 26 20 20 20 25 24 1 30 22 23 26 20 25 23 23 23 23 23 23 23 23 23 26 20 20 20 20 20 20 
20 20 20 20 20 20 20 21 33 33 33 33 33 1 1 1 1 1 1 1 1 22 23 23 23 24 1 1 30 30 30 22 23 24 3 4 4 4 4 4 4 4 5 22 26 20 20 20 20 20 
20 20 20 20 20 20 20 21 33 29 37 29 33 30 30 30 30 30 30 30 1 1 6 7 8 1 1 30 30 30 30 30 30 3 15 7 7 7 7 7 7 7 14 5 19 20 20 20 20 20 
20 20 20 20 20 20 20 21 33 29 29 29 33 30 30 30 30 30 30 30 30 1 6 7 8 1 30 30 30 30 30 30 30 6 7 7 7 7 7 7 7 7 7 8 19 20 20 20 20 20 
20 20 20 20 20 20 20 21 33 29 29 29 33 30 30 30 30 30 30 30 30 30 6 7 8 30 30 30 30 30 30 30 30 6 7 7 7 7 7 7 7 7 7 8 19 20 20 20 20 20 
20 20 20 20 20 20 20 21 33 29 29 29 33 30 30 30 30 30 30 30 30 30 6 7 8 30 30 30 30 30 30 30 30 6 7 7 7 7 7 7 7 7 7 8 19 20 20 20 20 20 
20 20 20 20 20 20 20 21 33 33 29 33 33 30 30 30 30 30 30 30 30 30 6 7 8 30 30 30 30 30 30 30 30 6 7 7 7 7 7 7 7 7 7 8 19 20 20 20 20 20 
20 20 20 20 20 20 20 21 30 30 1 30 30 30 30 30 30 30 30 30 30 30 6 7 8 30 30 30 30 30 30 30 30 9 13 7 7 7 7 7 7 7 12 11 19 20 20 20 20 20 
20 20 20 20 20 20 20 21 30 30 1 30 30 30 30 30 30 30 30 30 30 30 6 7 8 1 1 1 30 30 30 30 30 30 9 10 10 13 7 12 10 10 11 16 28 20 20 20 20 20 
20 20 20 20 20 20 25 24 30 30 1 30 30 30 30 30 30 30 30 30 30 30 6 7 8 30 30 30 30 30 30 30 30 30 30 30 30 6 7 8 30 16 17 28 20 20 20 20 20 20 
20 20 20 20 20 20 21 30 30 1 1 30 30 30 30 30 30 30 30 30 30 30 6 7 8 30 30 30 30 30 30 30 30 30 30 30 30 6 7 8 16 28 20 20 20 20 20 20 20 20 
20 20 20 20 20 20 21 30 1 1 1 30 30 30 30 30 30 30 30 30 30 30 6 7 8 30 30 30 30 30 30 30 30 30 30 30 30 6 7 8 19 20 20 20 20 20 20 20 20 20 
20 20 20 20 20 20 21 30 1 1 1 30 30 30 30 30 30 30 30 30 30 30 6 7 8 30 30 30 30 30 30 30 30 30 30 30 30 6 7 8 19 20 20 20 20 20 20 20 20 20 
20 20 20 20 20 20 21 1 1 1 1 30 30 30 30 30 30 30 30 30 30 30 6 7 8 30 30 30 30 30 30 30 30 30 30 3 4 15 7 8 19 20 20 20 20 20 20 20 20 20 
20 20 20 20 20 20 21 1 1 1 30 30 30 30 30 30 30 30 30 30 30 1 6 7 8 1 30 30 30 30 30 30 30 30 30 6 7 7 7 8 19 20 20 20 20 20 20 20 20 20 
20 20 20 20 20 20 21 1 1 30 30 30 30 30 30 30 30 30 30 30 1 3 15 7 14 5 1 30 30 30 30 30 30 30 3 15 7 12 10 11 19 20 20 20 20 20 20 20 20 20 
20 20 20 20 20 20 21 1 1 30 30 3 4 4 4 4 4 4 4 4 4 15 7 7 7 14 4 4 4 30 30 30 4 4 15 7 7 8 30 16 28 20 20 20 20 20 20 20 20 20 
20 20 20 20 20 20 21 1 1 30 30 6 7 7 7 7 7 7 7 7 7 7 7 7 7 7 7 7 7 7 7 7 7 7 7 7 7 8 30 19 20 20 20 20 20 20 20 20 20 20 
20 20 20 20 20 20 21 1 1 30 30 6 7 12 10 10 10 10 10 10 10 13 7 7 7 12 10 10 10 30 30 30 10 10 10 13 7 8 16 28 20 20 20 20 20 20 20 20 20 20 
20 20 20 20 20 20 21 1 1 30 30 30 10 30 30 30 30 30 30 30 1 9 13 7 12 11 1 30 30 30 30 30 30 30 30 6 7 8 19 20 20 20 20 20 20 20 20 20 20 20 
20 20 20 20 20 20 21 1 1 1 1 1 1 30 30 30 30 30 30 30 30 1 6 7 8 1 30 30 30 30 30 30 30 30 30 6 7 8 19 20 20 20 20 20 20 20 20 20 20 20 
20 20 20 20 20 20 21 1 1 30 30 30 1 1 1 30 30 30 30 30 30 30 6 7 8 30 30 30 30 30 30 30 30 30 30 6 7 8 19 20 20 20 20 20 20 20 20 20 20 20 
20 20 20 20 20 20 21 1 1 30 30 30 30 30 1 30 30 30 30 30 30 30 6 7 8 30 30 30 30 30 30 30 30 30 30 6 7 8 19 20 20 20 20 20 20 20 20 20 20 20 
20 20 20 20 20 20 21 30 1 30 30 30 30 30 1 30 30 30 30 30 30 30 6 7 8 30 30 30 30 30 30 30 30 30 30 6 7 8 19 20 20 20 20 20 20 20 20 20 20 20 
20 20 20 20 20 20 21 30 1 30 30 30 30 30 1 30 30 30 30 30 30 30 6 7 8 30 30 30 30 30 30 30 30 30 30 6 7 8 19 20 20 20 20 20 20 20 20 20 20 20 
20 20 20 20 20 20 21 1 1 1 1 1 1 1 1 30 30 30 30 30 30 30 6 7 8 30 30 30 30 30 30 30 30 30 30 6 7 8 19 20 20 20 20 20 20 20 20 20 20 20 
20 20 20 20 20 20 21 1 1 1 1 1 1 1 1 30 30 30 30 30 30 30 6 7 8 30 30 30 30 30 30 30 30 30 30 9 10 11 19 20 20 20 20 20 20 20 20 20 20 20 
20 20 20 20 20 20 21 1 1 1 1 1 1 1 1 30 30 30 30 30 30 30 6 7 8 30 30 30 30 30 30 30 30 30 30 1 1 1 19 20 20 20 20 20 20 20 20 20 20 20 
20 20 20 20 20 20 21 1 1 1 1 1 1 1 1 30 30 30 30 30 30 30 6 7 8 30 30 30 30 30 30 30 30 30 30 1 1 1 19 20 20 20 20 20 20 20 20 20 20 20 
20 20 20 20 20 20 21 1 1 1 1 1 1 1 1 30 30 30 30 30 30 30 6 7 8 30 30 30 30 30 30 30 30 30 30 1 1 1 19 20 20 20 20 20 20 20 20 20 20 20 
20 20 20 20 20 20 21 1 1 1 1 1 1 1 1 30 30 30 30 30 30 30 6 7 8 30 30 30 30 30 30 30 30 30 30 1 1 1 19 20 20 20 20 20 20 20 20 20 20 20 
20 20 20 20 20 20 21 30 30 30 30 30 30 30 30 30 30 30 30 30 30 30 6 7 8 30 30 30 30 30 30 30 30 30 30 1 1 1 22 26 20 20 20 20 20 20 20 20 20 20 
20 20 20 20 20 20 21 30 30 30 30 30 30 30 30 30 30 30 30 1 1 1 9 10 11 1 1 30 30 30 30 30 30 30 1 1 1 1 1 19 20 20 20 20 20 20 20 20 20 20 
20 20 20 20 20 20 21 30 30 30 30 30 30 30 30 30 30 30 1 1 1 1 1 1 1 1 1 1 30 30 30 30 30 1 1 1 1 1 1 19 20 20 20 20 20 20 20 20 20 20 
20 20 20 20 20 20 27 18 30 30 30 30 30 34 30 30 30 30 1 1 1 1 1 1 1 1 1 1 30 30 30 30 1 1 1 1 1 1 1 19 20 20 20 20 20 20 20 20 20 20 
20 20 20 20 20 20 20 27 18 30 30 30 30 1 30 1 1 1 1 1 1 1 1 1 1 1 1 1 1 30 30 30 1 1 1 1 1 30 1 19 20 20 20 20 20 20 20 20 20 20 
20 20 20 20 20 20 20 20 27 17 18 30 30 1 1 1 30 30 1 1 1 1 1 1 1 1 1 1 1 1 1 1 1 1 30 1 1 1 1 19 20 20 20 20 20 20 20 20 20 20 
20 20 20 20 20 20 20 20 20 20 27 18 30 30 30 30 16 17 18 1 1 1 1 1 1 1 1 1 1 1 1 1 1 1 1 1 1 1 1 19 20 20 20 20 20 20 20 20 20 20 
20 20 20 20 20 20 20 20 20 20 20 27 17 17 17 17 28 20 27 18 1 1 1 1 1 1 16 17 17 17 18 1 1 30 1 1 30 1 1 19 20 20 20 20 20 20 20 20 20 20 
20 20 20 20 20 20 20 20 20 20 20 20 20 20 20 20 20 20 20 27 17 17 17 17 17 17 28 20 20 20 27 18 1 1 1 1 1 1 16 28 20 20 20 20 20 20 20 20 20 20 
20 20 20 20 20 20 20 20 20 20 20 20 20 20 20 20 20 20 20 20 20 20 20 20 20 20 20 20 20 20 20 27 17 17 17 17 17 17 28 20 20 20 20 20 20 20 20 20 20 20 
20 20 20 20 20 20 20 20 20 20 20 20 20 20 20 20 20 20 20 20 20 20 20 20 20 20 20 20 20 20 20 20 20 20 20 20 20 20 20 20 20 20 20 20 20 20 20 20 20 20 
20 20 20 20 20 20 20 20 20 20 20 20 20 20 20 20 20 20 20 20 20 20 20 20 20 20 20 20 20 20 20 20 20 20 20 20 20 20 20 20 20 20 20 20 20 20 20 20 20 20 
20 20 20 20 20 20 20 20 20 20 20 20 20 20 20 20 20 20 20 20 20 20 20 20 20 20 20 20 20 20 20 20 20 20 20 20 20 20 20 20 20 20 20 20 20 20 20 20 20 20 
20 20 20 20 20 20 20 20 20 20 20 20 20 20 20 20 20 20 20 20 20 20 20 20 20 20 20 20 20 20 20 20 20 20 20 20 20 20 20 20 20 20 20 20 20 20 20 20 20 20 
