14 14 14 14 14 14 14 14 14 14 14 14 14 14 14 14 14 14 14 28 26 26 26 26 26 26 26 29 14 14 14 14 14 14 14 14 14 14 14 14 14 14 14 14 14 14 14 14 14 14
14 14 14 14 14 14 14 14 14 14 14 14 14 14 14 14 14 14 28 27 10 10 10 10 10 10 10 25 29 14 14 14 14 14 14 14 14 14 14 14 14 14 14 14 14 14 14 14 14 14
14 14 14 14 14 14 14 14 14 14 14 14 14 14 14 14 14 14 24 10 10 20 21 21 21 22 10 10 23 14 14 14 14 14 14 14 14 14 14 14 14 14 14 14 14 14 14 14 14 14
14 14 14 14 14 14 14 14 14 14 14 14 14 14 14 14 14 14 24 10 20 31 14 14 14 30 22 10 23 14 14 14 14 14 14 14 14 14 14 14 14 14 14 14 14 14 14 14 14 14
14 14 14 14 14 14 14 14 14 14 14 14 14 14 14 28 26 26 27 10 23 14 14 14 14 14 24 10 25 29 14 14 14 14 14 14 14 14 14 14 14 14 14 14 14 14 14 14 14 14
14 14 14 14 14 14 14 28 26 26 26 26 26 26 26 27 16 16 16 10 25 29 14 14 14 28 27 10 16 25 26 29 14 28 26 26 26 26 26 26 26 26 26 29 14 14 14 14 14 14
14 14 14 14 14 14 14 24 12 12 12 12 12 16 16 16 16 16 16 10 10 25 26 26 26 27 10 10 16 16 16 25 26 27 33 34 34 34 34 34 34 34 35 25 29 14 14 14 14 14
14 14 14 14 14 14 14 24 12 19 19 19 12 16 16 16 16 16 16 16 10 10 36 19 37 10 10 16 16 16 16 16 16 33 44 19 19 19 19 19 19 19 43 35 23 14 14 14 14 14
14 14 14 14 14 14 14 24 12 19 19 19 12 16 16 16 16 16 16 16 16 10 36 19 37 10 16 16 16 16 16 16 16 36 19 19 19 19 19 19 19 19 19 37 23 14 14 14 14 14
14 14 14 14 14 14 14 24 12 19 19 19 12 16 16 16 16 16 16 16 16 16 36 19 37 16 16 16 16 16 16 16 16 36 19 19 19 19 19 19 19 19 19 37 23 14 14 14 14 14
14 14 14 14 14 14 14 24 12 19 19 19 12 16 16 16 16 16 16 16 16 16 36 19 37 16 16 16 16 16 16 16 16 36 19 19 19 19 19 19 19 19 19 37 23 14 14 14 14 14
14 14 14 14 14 14 14 24 12 12 39 12 12 16 16 16 16 16 16 16 16 16 36 19 37 16 16 16 16 16 16 16 16 36 19 19 19 19 19 19 19 19 19 37 23 14 14 14 14 14
14 14 14 14 14 14 14 24 16 16 10 16 16 16 16 16 16 16 16 16 16 16 36 19 37 16 16 16 16 16 16 16 16 38 42 19 19 19 19 19 19 19 41 40 23 14 14 14 14 14
14 14 14 14 14 14 14 24 16 16 10 16 16 16 16 16 16 16 16 16 16 16 36 19 37 10 10 10 16 16 16 16 16 16 38 39 39 42 19 41 39 39 40 20 31 14 14 14 14 14
14 14 14 14 14 14 28 27 16 16 10 16 16 16 16 16 16 16 16 16 16 16 36 19 37 16 16 16 16 16 16 16 16 16 16 16 16 36 19 37 16 20 21 31 14 14 14 14 14 14
14 14 14 14 14 14 24 16 16 10 10 16 16 16 16 16 16 16 16 16 16 16 36 19 37 16 16 16 16 16 16 16 16 16 16 16 16 36 19 37 20 31 14 14 14 14 14 14 14 14
14 14 14 14 14 14 24 16 10 10 10 16 16 16 16 16 16 16 16 16 16 16 36 19 37 16 16 16 16 16 16 16 16 16 16 16 16 36 19 37 23 14 14 14 14 14 14 14 14 14
14 14 14 14 14 14 24 16 10 10 10 16 16 16 16 16 16 16 16 16 16 16 36 19 37 16 16 16 16 16 16 16 16 16 16 16 16 36 19 37 23 14 14 14 14 14 14 14 14 14
14 14 14 14 14 14 24 10 10 10 10 16 16 16 16 16 16 16 16 16 16 16 36 19 37 16 16 16 16 16 16 16 16 16 16 33 34 44 19 37 23 14 14 14 14 14 14 14 14 14
14 14 14 14 14 14 24 10 10 10 16 16 16 16 16 16 16 16 16 16 16 10 36 19 37 10 16 16 16 16 16 16 16 16 16 36 19 19 19 37 23 14 14 14 14 14 14 14 14 14
14 14 14 14 14 14 24 10 10 16 16 16 16 16 16 16 16 16 16 16 10 10 36 19 37 10 10 16 16 16 16 16 16 16 33 44 19 41 39 40 23 14 14 14 14 14 14 14 14 14
14 14 14 14 14 14 24 10 10 16 16 33 34 34 34 34 34 34 34 34 34 34 44 19 43 34 34 34 34 16 16 16 34 34 44 19 19 37 16 20 31 14 14 14 14 14 14 14 14 14
14 14 14 14 14 14 24 10 10 10 10 36 19 19 19 19 19 19 19 19 19 19 19 19 19 19 19 19 19 19 19 19 19 19 19 19 19 37 16 23 14 14 14 14 14 14 14 14 14 14
14 14 14 14 14 14 24 10 10 16 16 36 19 41 39 39 39 39 39 39 39 39 42 19 41 39 39 39 39 16 16 16 39 39 39 42 19 37 20 31 14 14 14 14 14 14 14 14 14 14
14 14 14 14 14 14 24 10 10 16 16 16 39 16 16 16 16 16 16 16 10 10 36 19 37 10 10 16 16 16 16 16 16 16 16 36 19 37 23 14 14 14 14 14 14 14 14 14 14 14
14 14 14 14 14 14 24 10 10 16 16 16 10 16 16 16 16 16 16 16 16 10 36 19 37 10 16 16 16 16 16 16 16 16 16 36 19 37 23 14 14 14 14 14 14 14 14 14 14 14
14 14 14 14 14 14 24 10 10 16 16 16 10 10 10 16 16 16 16 16 16 16 36 19 37 16 16 16 16 16 16 16 16 16 16 36 19 37 23 14 14 14 14 14 14 14 14 14 14 14
14 14 14 14 14 14 24 10 10 16 16 16 16 16 10 16 16 16 16 16 16 16 36 19 37 16 16 16 16 16 16 16 16 16 16 36 19 37 23 14 14 14 14 14 14 14 14 14 14 14
14 14 14 14 14 14 24 16 10 16 16 16 16 16 10 16 16 16 16 16 16 16 36 19 37 16 16 16 16 16 16 16 16 16 16 36 19 37 23 14 14 14 14 14 14 14 14 14 14 14
14 14 14 14 14 14 24 16 10 16 16 16 16 16 10 16 16 16 16 16 16 16 36 19 37 16 16 16 16 16 16 16 16 16 16 36 19 37 23 14 14 14 14 14 14 14 14 14 14 14
14 14 14 14 14 14 24 10 10 10 10 10 10 10 10 16 16 16 16 16 16 16 36 19 37 16 16 16 16 16 16 16 16 16 16 36 19 37 23 14 14 14 14 14 14 14 14 14 14 14
14 14 14 14 14 14 24 10 10 10 10 10 10 10 10 16 16 16 16 16 16 16 36 19 37 16 16 16 16 16 16 16 16 16 16 38 39 40 23 14 14 14 14 14 14 14 14 14 14 14
14 14 14 14 14 14 24 10 10 10 10 10 10 10 10 16 16 16 16 16 16 16 36 19 37 16 16 16 16 16 16 16 16 16 16 10 10 10 23 14 14 14 14 14 14 14 14 14 14 14
14 14 14 14 14 14 24 10 10 10 10 10 10 10 10 16 16 16 16 16 16 16 36 19 37 16 16 16 16 16 16 16 16 16 16 10 10 10 23 14 14 14 14 14 14 14 14 14 14 14
14 14 14 14 14 14 24 10 10 10 10 10 10 10 10 16 16 16 16 16 16 16 36 19 37 16 16 16 16 16 16 16 16 16 16 10 10 10 23 14 14 14 14 14 14 14 14 14 14 14
14 14 14 14 14 14 24 10 10 10 10 10 10 10 10 16 16 16 16 16 16 16 36 19 37 16 16 16 16 16 16 16 16 16 16 10 10 10 23 14 14 14 14 14 14 14 14 14 14 14
14 14 14 14 14 14 24 16 16 16 16 16 16 16 16 16 16 16 16 16 16 16 36 19 37 16 16 16 16 16 16 16 16 16 16 10 10 10 25 29 14 14 14 14 14 14 14 14 14 14
14 14 14 14 14 14 24 16 16 16 16 16 16 16 16 16 16 16 16 10 10 10 38 39 40 10 10 16 16 16 16 16 16 16 10 10 10 10 10 23 14 14 14 14 14 14 14 14 14 14
14 14 14 14 14 14 24 16 16 16 16 16 16 16 16 16 16 16 10 10 10 10 10 10 10 10 10 10 16 16 16 16 16 10 10 10 10 10 10 23 14 14 14 14 14 14 14 14 14 14
14 14 14 14 14 14 30 22 16 16 16 16 16 45 16 16 16 16 10 10 10 10 10 10 10 10 10 10 16 16 16 16 10 10 10 10 10 10 10 23 14 14 14 14 14 14 14 14 14 14
14 14 14 14 14 14 14 30 22 16 16 16 16 10 16 10 10 10 10 10 10 10 10 10 10 10 10 10 10 16 16 16 10 10 10 10 10 16 10 23 14 14 14 14 14 14 14 14 14 14
14 14 14 14 14 14 14 14 30 21 22 16 16 10 10 10 16 16 10 10 10 10 10 10 10 10 10 10 10 10 10 10 10 10 16 10 10 10 10 23 14 14 14 14 14 14 14 14 14 14
14 14 14 14 14 14 14 14 14 14 30 22 16 16 16 16 20 21 22 10 10 10 10 10 10 10 10 10 10 10 10 10 10 10 10 10 10 10 10 23 14 14 14 14 14 14 14 14 14 14
14 14 14 14 14 14 14 14 14 14 14 30 21 21 21 21 31 14 30 22 10 10 10 10 10 10 20 21 21 21 22 10 10 16 10 10 16 10 10 23 14 14 14 14 14 14 14 14 14 14
14 14 14 14 14 14 14 14 14 14 14 14 14 14 14 14 14 14 14 30 21 21 21 21 21 21 31 14 14 14 30 22 10 10 10 10 10 10 20 31 14 14 14 14 14 14 14 14 14 14
14 14 14 14 14 14 14 14 14 14 14 14 14 14 14 14 14 14 14 14 14 14 14 14 14 14 14 14 14 14 14 30 21 21 21 21 21 21 31 14 14 14 14 14 14 14 14 14 14 14
14 14 14 14 14 14 14 14 14 14 14 14 14 14 14 14 14 14 14 14 14 14 14 14 14 14 14 14 14 14 14 14 14 14 14 14 14 14 14 14 14 14 14 14 14 14 14 14 14 14
14 14 14 14 14 14 14 14 14 14 14 14 14 14 14 14 14 14 14 14 14 14 14 14 14 14 14 14 14 14 14 14 14 14 14 14 14 14 14 14 14 14 14 14 14 14 14 14 14 14
14 14 14 14 14 14 14 14 14 14 14 14 14 14 14 14 14 14 14 14 14 14 14 14 14 14 14 14 14 14 14 14 14 14 14 14 14 14 14 14 14 14 14 14 14 14 14 14 14 14
14 14 14 14 14 14 14 14 14 14 14 14 14 14 14 14 14 14 14 14 14 14 14 14 14 14 14 14 14 14 14 14 14 14 14 14 14 14 14 14 14 14 14 14 14 14 14 14 14 14
14 14 14 14 14 14 14 14 14 14 14 14 14 14 14 14 14 14 14 14 14 14 14 14 14 14 14 14 14 14 14 14 14 14 14 14 14 14 14 14 14 14 14 14 14 14 14 14 14 14