5 5 5 5 5 6 6 6 6 6 6 6 6 6 6 6 6 6 6 6 6 6 6 6 6 6 6 6 6 6 6 6 6 6 6 6 6 6 6 6 6 6 6 6 6 6 6 6 6 6
5 10 10 10 27 9 9 9 9 9 9 9 6 6 6 6 6 6 6 6 6 6 6 6 6 6 6 6 6 6 6 6 6 6 6 6 6 6 6 6 6 6 6 6 6 6 6 6 6 6
5 5 5 5 5 6 6 6 6 9 9 9 6 6 6 6 6 6 6 6 6 11 12 12 12 13 6 6 6 6 6 6 6 6 6 6 6 6 6 6 6 6 6 6 6 6 6 6 6 6
6 6 6 6 6 6 6 6 6 9 9 9 6 6 6 6 6 6 6 6 11 22 4 4 4 21 13 6 6 6 6 6 6 6 6 6 6 6 6 6 6 6 6 6 6 6 6 6 6 6
6 6 6 6 6 6 6 6 6 9 9 9 6 6 6 6 6 6 6 6 14 4 4 4 4 4 15 6 6 6 6 6 6 6 6 6 6 6 6 6 6 6 6 6 6 6 6 6 6 6
6 6 6 6 6 6 6 6 6 9 9 9 6 6 6 6 6 6 6 6 16 20 4 4 4 19 18 6 6 6 6 6 6 6 6 6 6 6 6 6 6 6 6 6 6 6 6 6 6 6
6 6 6 6 6 6 6 6 2 3 3 3 2 6 6 6 6 6 6 6 0 16 17 17 17 18 0 6 6 6 6 6 6 6 23 24 24 24 24 24 24 24 25 6 6 6 6 6 6 6
6 6 6 6 6 6 6 6 2 10 10 10 2 6 6 6 6 6 6 6 0 0 26 10 27 0 0 6 6 6 6 6 6 23 34 10 10 10 10 10 10 10 33 25 6 6 6 6 6 6
6 6 6 6 6 6 6 6 2 10 10 10 2 6 6 6 6 6 6 6 6 0 26 10 27 0 6 6 6 6 6 6 6 26 10 10 10 10 10 10 10 10 10 27 6 6 6 6 6 6
6 6 6 6 6 6 6 6 2 10 10 10 2 6 6 6 6 6 6 6 6 6 26 10 27 6 6 6 6 6 6 6 6 26 10 10 10 10 10 10 10 10 10 27 6 6 6 6 6 6
6 6 6 6 6 6 6 6 2 10 10 10 2 6 6 6 6 6 6 6 6 6 26 10 27 6 6 6 6 6 6 6 6 26 10 10 10 10 10 10 10 10 10 27 6 6 6 6 6 6
6 6 6 6 6 6 6 6 2 2 29 2 2 6 6 6 6 6 6 6 6 6 26 10 27 6 6 6 6 6 6 6 6 26 10 10 10 10 10 10 10 10 10 27 6 6 6 6 6 6
6 6 6 6 6 6 6 6 6 6 0 6 6 6 6 6 6 6 6 6 6 6 26 10 27 6 6 6 6 6 6 6 6 28 32 10 10 10 10 10 10 10 31 30 6 6 6 6 6 6
6 6 6 6 6 6 6 6 6 6 0 6 6 6 6 6 6 6 6 6 6 6 26 10 27 6 6 6 6 6 6 6 6 6 28 29 29 32 10 31 29 29 30 6 6 6 6 6 6 6
6 6 6 6 6 6 6 6 6 6 0 6 6 6 6 6 6 6 6 6 6 6 26 10 27 6 6 6 6 6 6 6 6 6 6 6 6 26 10 27 6 6 6 6 6 6 6 6 6 6
6 6 6 6 6 6 6 6 6 6 0 6 6 6 6 6 6 6 6 6 6 6 26 10 27 6 6 6 6 6 6 6 6 6 6 6 6 26 10 27 6 6 6 6 6 6 6 6 6 6
6 6 6 6 6 6 6 6 0 0 0 6 6 6 6 6 6 6 6 6 6 6 26 10 27 6 6 6 6 6 6 6 6 6 6 6 6 26 10 27 6 6 6 6 6 6 6 6 6 6
6 6 6 6 6 6 6 6 0 6 6 6 6 6 6 6 6 6 6 6 6 6 26 10 27 6 6 6 6 6 6 6 6 6 6 23 24 34 10 27 6 6 6 6 6 6 6 6 6 6
6 6 6 6 6 6 6 6 0 6 6 6 6 6 6 6 6 6 6 6 6 6 26 10 27 6 6 6 6 6 6 6 6 6 6 26 10 10 10 27 6 6 6 6 6 6 6 6 6 6
6 6 6 6 6 6 6 6 0 6 6 6 6 6 6 6 6 6 6 6 6 0 26 10 27 0 6 6 6 6 6 6 6 6 23 34 10 31 29 30 6 6 6 6 6 6 6 6 6 6
6 6 6 6 6 6 6 6 0 6 6 23 24 24 24 24 24 24 24 24 24 24 34 10 33 24 24 24 24 24 24 24 24 24 34 10 10 27 6 6 6 6 6 6 6 6 6 6 6 6
6 6 6 6 6 6 6 6 0 6 6 26 10 10 10 10 10 10 10 10 10 10 10 10 10 10 10 10 10 10 10 10 10 10 10 10 10 27 6 6 6 6 6 6 6 6 6 6 6 6
6 6 6 6 6 6 6 6 0 6 6 26 10 31 29 29 29 29 29 29 29 29 32 10 31 29 29 29 29 29 29 29 29 29 29 32 10 27 6 6 6 6 6 6 6 6 6 6 6 6
6 6 6 6 6 6 6 6 0 6 6 6 29 6 6 6 6 6 6 6 6 0 26 10 27 0 6 6 6 6 6 6 6 6 6 26 10 27 6 6 6 6 6 6 6 6 6 6 6 6
6 6 6 6 6 6 6 6 0 6 6 6 0 6 6 6 6 6 6 6 6 6 26 10 27 6 6 6 6 6 6 6 6 6 6 26 10 27 6 6 6 6 6 6 6 6 6 6 6 6
6 6 6 6 6 6 6 6 0 6 6 6 0 0 0 6 6 6 6 6 6 6 26 10 27 6 6 6 6 6 6 6 6 6 6 26 10 27 6 6 6 6 6 6 6 6 6 6 6 6
6 6 6 6 6 6 6 6 0 6 6 6 6 6 0 6 6 6 6 6 6 6 26 10 27 6 6 6 6 6 6 6 6 6 6 26 10 27 6 6 6 6 6 6 6 6 6 6 6 6
6 6 6 6 6 6 6 6 0 6 6 6 6 6 0 6 6 6 6 6 6 6 26 10 27 6 6 6 6 6 6 6 6 6 6 26 10 27 6 6 6 6 6 6 6 6 6 6 6 6
6 6 6 6 6 6 6 6 0 6 6 6 6 6 0 6 6 6 6 6 6 6 26 10 27 6 6 6 6 6 6 6 6 6 6 26 10 27 6 6 6 6 6 6 6 6 6 6 6 6
6 6 6 6 6 6 6 6 0 0 0 0 0 0 0 6 6 6 6 6 6 6 26 10 27 6 6 6 6 6 6 6 6 6 6 26 10 27 6 6 6 6 6 6 6 6 6 6 6 6
6 6 6 6 6 6 6 6 0 0 0 0 0 0 0 6 6 6 6 6 6 6 26 10 27 6 6 6 6 6 6 6 6 6 6 28 29 30 6 6 6 6 6 6 6 6 6 6 6 6
6 6 6 6 6 6 6 6 0 0 0 0 0 0 0 6 6 6 6 6 6 6 26 10 27 6 6 6 6 6 6 6 6 6 6 0 0 0 6 6 6 6 6 6 6 6 6 6 6 6
6 6 6 6 6 6 6 6 0 0 0 0 0 0 0 6 6 6 6 6 6 6 26 10 27 6 6 6 6 6 6 6 6 6 6 0 0 0 6 6 6 6 6 6 6 6 6 6 6 6
6 6 6 6 6 6 6 6 0 0 0 0 0 0 0 6 6 6 6 6 6 6 26 10 27 6 6 6 6 6 6 6 6 6 6 0 0 0 6 6 6 6 6 6 6 6 6 6 6 6
6 6 6 6 6 6 6 6 0 0 0 0 0 0 0 6 6 6 6 6 6 6 26 10 27 6 6 6 6 6 6 6 6 6 6 0 0 0 6 6 6 6 6 6 6 6 6 6 6 6
6 6 6 6 6 6 6 6 6 6 6 6 6 6 6 6 6 6 6 6 6 6 26 10 27 6 6 6 6 6 6 6 6 6 6 0 0 0 6 6 6 6 6 6 6 6 6 6 6 6
6 6 6 6 6 6 6 6 6 6 6 6 6 6 6 6 6 6 6 0 0 0 28 29 30 0 0 6 6 6 6 6 6 6 0 0 0 0 0 6 6 6 6 6 6 6 6 6 6 6
6 6 6 6 6 6 6 6 6 6 6 6 6 6 6 6 6 6 0 0 0 0 0 0 0 0 0 0 6 6 6 6 6 0 0 0 0 0 0 6 6 6 6 6 6 6 6 6 6 6
6 6 6 6 6 6 6 6 6 6 6 6 6 6 6 6 6 6 0 0 0 0 0 0 0 0 0 0 6 6 6 6 0 0 0 0 0 0 0 6 6 6 6 6 6 6 6 6 6 6 
6 6 6 6 6 6 6 6 6 6 6 6 6 6 6 6 6 6 0 0 0 0 0 0 0 0 0 0 0 6 6 6 0 0 0 0 0 6 0 6 6 6 6 6 6 6 6 6 6 6
6 6 6 6 6 6 6 6 6 6 6 6 6 6 6 6 6 6 0 0 0 0 0 0 0 0 0 0 0 0 0 0 0 0 6 0 0 0 0 6 6 6 6 6 6 6 6 6 6 6 
6 6 6 6 6 6 6 6 6 6 6 6 6 6 6 6 6 6 6 0 0 0 0 0 0 0 0 6 6 6 6 0 0 0 0 0 0 0 0 6 6 6 6 6 6 6 6 6 6 6
6 6 6 6 6 6 6 6 6 6 6 6 6 6 6 6 6 6 6 6 0 0 0 0 0 0 6 6 6 6 6 0 0 6 0 0 6 0 0 6 6 6 6 6 6 6 6 6 6 6
6 6 6 6 6 6 6 6 6 6 6 6 6 6 6 6 6 6 6 6 9 6 6 6 6 6 6 6 6 6 6 6 0 0 0 0 0 0 6 6 6 6 6 6 6 6 6 6 6 6
6 6 6 6 6 6 6 6 6 6 6 6 6 6 6 6 6 6 6 6 9 6 6 6 6 6 6 6 6 6 6 6 9 6 6 6 6 6 6 6 6 6 6 6 6 6 6 6 6 6
6 6 6 6 6 6 6 6 6 6 6 6 6 6 6 6 6 6 6 6 9 6 6 6 6 6 6 6 6 6 6 6 9 6 6 6 6 6 6 6 6 6 6 6 6 6 6 6 6 6
6 6 6 6 6 6 6 6 6 6 6 6 6 6 6 6 6 6 6 6 9 6 6 6 6 6 6 6 6 6 6 6 9 6 6 6 6 6 6 6 6 6 6 6 6 6 6 6 6 6
6 6 6 6 6 5 5 5 5 6 6 6 6 6 6 6 6 6 6 6 9 6 6 6 6 6 6 6 6 6 6 6 9 6 6 6 6 6 6 6 6 6 6 6 6 6 6 6 6 6
6 6 6 6 6 5 10 10 27 9 9 9 9 9 9 9 9 9 9 9 9 9 9 9 9 9 9 9 9 9 9 9 9 9 9 9 6 6 6 6 6 6 6 6 6 6 6 6 6 6
6 6 6 6 6 5 5 5 5 6 6 6 6 6 6 6 6 6 6 6 6 6 6 6 6 6 6 6 6 6 6 6 6 6 6 6 6 6 6 6 6 6 6 6 6 6 6 6 6 6